"filename", "language", "C++", "C", "Markdown", "comment", "blank", "total"
"/Users/zhangxu/Desktop/DataStructure_Test/Bit_Control.c", "C", 0, 21, 0, 1, 2, 24
"/Users/zhangxu/Desktop/DataStructure_Test/Hash.c", "C", 0, 127, 0, 30, 8, 165
"/Users/zhangxu/Desktop/DataStructure_Test/Hash.h", "C++", 24, 0, 0, 7, 2, 33
"/Users/zhangxu/Desktop/DataStructure_Test/LeetCode/LeetCode_01.c", "C", 0, 65, 0, 19, 5, 89
"/Users/zhangxu/Desktop/DataStructure_Test/LeetCode/LeetCode_02.c", "C", 0, 49, 0, 10, 1, 60
"/Users/zhangxu/Desktop/DataStructure_Test/LeetCode/LeetCode_03.c", "C", 0, 29, 0, 2, 1, 32
"/Users/zhangxu/Desktop/DataStructure_Test/LeetCode/LeetCode_19.c", "C", 0, 55, 0, 12, 5, 72
"/Users/zhangxu/Desktop/DataStructure_Test/LeetCode/LeetCode_20.c", "C", 0, 58, 0, 4, 2, 64
"/Users/zhangxu/Desktop/DataStructure_Test/LeetCode/LeetCode_21.c", "C", 0, 31, 0, 5, 2, 38
"/Users/zhangxu/Desktop/DataStructure_Test/LeetCode/LeetCode_704.c", "C", 0, 34, 0, 0, 2, 36
"/Users/zhangxu/Desktop/DataStructure_Test/LeetCode/YingShiMianShi.c", "C", 0, 28, 0, 10, 4, 42
"/Users/zhangxu/Desktop/DataStructure_Test/Markdown/C语言函数学习记录.md", "Markdown", 0, 0, 512, 0, 50, 562
"/Users/zhangxu/Desktop/DataStructure_Test/Markdown/LeetCode刷题笔记.md", "Markdown", 0, 0, 1, 0, 2, 3
"/Users/zhangxu/Desktop/DataStructure_Test/Markdown/uthash库学习记录.md", "Markdown", 0, 0, 296, 0, 44, 340
"/Users/zhangxu/Desktop/DataStructure_Test/Markdown/算法学习笔记.md", "Markdown", 0, 0, 484, 0, 38, 522
"/Users/zhangxu/Desktop/DataStructure_Test/Sort.c", "C", 0, 119, 0, 12, 3, 134
"/Users/zhangxu/Desktop/DataStructure_Test/Uthash/utarray.h", "C++", 192, 0, 0, 25, 32, 249
"/Users/zhangxu/Desktop/DataStructure_Test/Uthash/uthash.h", "C", 0, 926, 0, 123, 90, 1139
"/Users/zhangxu/Desktop/DataStructure_Test/Uthash/utlist.h", "C++", 889, 0, 0, 79, 106, 1074
"/Users/zhangxu/Desktop/DataStructure_Test/Uthash/utringbuffer.h", "C++", 69, 0, 0, 24, 16, 109
"/Users/zhangxu/Desktop/DataStructure_Test/Uthash/utstack.h", "C++", 27, 0, 0, 49, 13, 89
"/Users/zhangxu/Desktop/DataStructure_Test/Uthash/utstring.h", "C++", 316, 0, 0, 42, 50, 408
"/Users/zhangxu/Desktop/DataStructure_Test/heap.c", "C", 0, 51, 0, 4, 0, 55
"/Users/zhangxu/Desktop/DataStructure_Test/mytree.c", "C", 0, 52, 0, 9, 5, 66
"/Users/zhangxu/Desktop/DataStructure_Test/mytree.h", "C++", 46, 0, 0, 10, 7, 63
"/Users/zhangxu/Desktop/DataStructure_Test/queue.c", "C", 0, 61, 0, 6, 7, 74
"/Users/zhangxu/Desktop/DataStructure_Test/queue.h", "C++", 26, 0, 0, 7, 6, 39
"/Users/zhangxu/Desktop/DataStructure_Test/stack.c", "C", 0, 209, 0, 56, 11, 276
"/Users/zhangxu/Desktop/DataStructure_Test/stack.h", "C++", 41, 0, 0, 19, 4, 64
"/Users/zhangxu/Desktop/DataStructure_Test/string_test.c", "C", 0, 94, 0, 5, 4, 103
"/Users/zhangxu/Desktop/DataStructure_Test/string_test.h", "C++", 15, 0, 0, 2, 2, 19
"/Users/zhangxu/Desktop/DataStructure_Test/tempCodeRunnerFile.c", "C", 0, 1, 0, 0, 0, 1
"/Users/zhangxu/Desktop/DataStructure_Test/test.c", "C", 0, 53, 0, 2, 3, 58
"/Users/zhangxu/Desktop/DataStructure_Test/字符串函数操作测试文件.c", "C", 0, 80, 0, 3, 3, 86
"Total", "-", 1645, 2143, 1293, 577, 530, 6188